2 2 2 2 2 2 2 2 2 2 2 2 2 2 2 2
2 0 0 7 10 5 0 0 0 0 0 0 7 10 5 0
2 0 0 7 11 5 0 9 9 9 9 0 7 11 5 0
2 0 0 7 10 5 0 0 0 0 0 0 7 10 5 0
2 0 0 7 11 5 0 9 9 9 9 0 7 11 5 0
0 0 0 8 0 6 0 0 0 0 0 0 8 0 6 0
0 0 0 0 0 0 0 0 0 0 0 0 0 0 0 0
0 0 0 0 0 0 0 0 0 0 0 0 0 0 0 0
2 0 0 0 0 0 0 0 0 0 0 0 0 0 0 0
2 0 0 0 0 0 0 0 0 0 0 0 0 0 0 0
2 0 0 0 0 0 0 0 0 0 0 0 0 0 0 0
2 0 0 0 0 0 0 0 0 0 0 0 0 0 0 0
